1
11 10
...o......
...o......
..oo......
...o......
..........
..........
x.........
xx........
x.........
x.........
..........